siya	siya	PRONOUN
sila	sila	PRONOUN
sina	sina	PRONOUN
ano	ano	PRONOUN
tayo	tayo	PRONOUN
kami	kami	PRONOUN
kayo	kayo	PRONOUN
ako	ako	PRONOUN
dito	dito	DEMONSTRATIVE
rito	rito	DEMONSTRATIVE
doon	doon	DEMONSTRATIVE
roon	roon	DEMONSTRATIVE
daw	daw	ASPECTUAL
raw	raw	ASPECTUAL
din	din	ASPECTUAL
rin	rin	ASPECTUAL
ng	ng	ASPECTUAL
nang	nang	ASPECTUAL
nagpunta	nagpunta	VERB
sinabi	sinabi	VERB
nagsabi	nagsabi	VERB
napansin	napansin	VERB
pwede	pwede	VERB
pipila	pipila	VERB
gala	gala	VERB
sumama	sumama	VERB
tumakbo	tumakbo	VERB
pumila	pumila	VERB
magkikita	magkikita	VERB
sasama	sasama	VERB
papunta	papunta	VERB
sabi	sabi	VERB
kainin	kainin	VERB
kumain	kumain	VERB
kakain	kakain	VERB
lumangoy	lumangoy	VERB
lalangoy	lalangoy	VERB
sakay	sakay	VERB
sumakay	sumakay	VERB
sasakay	sasakay	VERB
lingon	lingon	VERB
lumingon	lumingon	VERB
lilingon	lilingon	VERB
kain	kain	VERB
sayaw	sayaw	VERB
tawa	tawa	VERB
ikot	ikot	VERB
ihi	ihi	VERB
lakad	lakad	VERB
takbo	takbo	VERB
iyak	iyak	VERB
kaway	kaway	VERB
upo	upo	VERB
basa	basa	VERB
ligo	ligo	VERB
bigay	bigay	VERB
usap	usap	VERB
sulat	sulat	VERB
sabi	sabi	VERB
luto	luto	VERB
hintay	hintay	VERB
gising	gising	VERB
alam	alam	VERB
maganda	maganda	ADJECTIVE
pogi	pogi	ADJECTIVE
marami	marami	ADJECTIVE
mataba	mataba	ADJECTIVE
malangsa	malangsa	ADJECTIVE
mabaho	mabaho	ADJECTIVE
maputi	maputi	ADJECTIVE
maamo	maamo	ADJECTIVE
madumi	madumi	ADJECTIVE
matangkad	matangkad	ADJECTIVE
mapayat	mapayat	ADJECTIVE
maayos	maayos	ADJECTIVE
malinis	malinis	ADJECTIVE
pangit	pangit	ADJECTIVE
mainit	mainit	ADJECTIVE
malamig	malamig	ADJECTIVE
maliit	maliit	ADJECTIVE
mabilis	mabilis	ADJECTIVE
mabagal	mabagal	ADJECTIVE
mataas	mataas	ADJECTIVE
matulin	matulin	ADJECTIVE
masarap	masarap	ADJECTIVE
matino	matino	ADJECTIVE
mahina	mahina	ADJECTIVE
mabuti	mabuti	ADJECTIVE
paki	paki	PREFIX
ay	ay	PARTICLE
